level1
0
0
w w w w w w w w w w w w 
w 0 0 0 0 0 0 0 0 0 0 w 
w 0 0 0 0 0 0 0 0 0 0 w 
w 0 0 0 0 0 0 0 0 0 0 w 
w 0 0 0 0 0 0 0 0 0 0 w 
w 0 0 0 c 0 0 0 0 f 0 w 
w w w w w w w w w w w w 
