level2
0
0
12
12
w w w w w w w w w w w w 
w 0 0 0 0 0 0 0 0 0 0 w 
w 0 0 0 0 0 0 0 0 0 0 w 
w 0 0 0 0 0 0 0 0 0 0 w 
w 0 0 0 0 0 0 0 0 0 0 w 
w 0 0 0 0 0 0 0 0 0 0 w 
w 0 0 0 0 0 0 0 0 0 0 w 
w 0 0 0 0 0 0 0 0 0 0 w 
w 0 0 0 0 w 0 0 0 0 0 w 
w 0 0 w 0 0 0 0 w 0 0 w 
w c 0 w 0 o o 0 w 0 f w 
w w w w w w w w w w w w 
