wwwwwwwwww
w00000000w
w00000000w
w00000000w
w00000000w
w00000000w
w00000000w
w000g0g00w
wc000000fw
wwwwwwwwww
