level1
0
0
7
7
w w w w w w w 
w 0 0 0 0 0 w 
w 0 0 0 0 0 w 
w 0 0 0 0 0 w 
w 0 0 0 0 0 w 
w c 0 0 0 f w 
w w w w w w w 
