level2
0
0
14
24
w w w w w w w w w w w w w w 
w 0 0 0 0 w 0 0 0 0 g g g w 
w 0 0 0 0 w 0 0 0 0 g g g w 
w 0 0 f 0 w 0 0 0 0 g g g w 
w 0 w w w w 0 0 0 0 w w w w 
w 0 0 0 0 0 0 0 0 w 0 0 0 w 
w 0 0 0 0 0 0 0 0 0 0 0 0 w 
w w w 0 0 0 0 0 0 0 0 0 0 w 
w 0 0 0 w 0 0 0 0 0 0 0 0 w 
w 0 0 0 0 0 w w w w w 0 0 w 
w 0 0 0 0 0 0 0 0 0 0 0 0 w 
w 0 0 0 0 0 0 0 0 0 0 0 w w 
w 0 0 0 0 0 0 0 0 0 0 w 0 w 
w 0 0 w 0 w 0 0 w 0 w 0 0 w 
w 0 0 0 0 0 0 0 0 0 0 0 0 w 
w w 0 0 0 0 g g 0 0 0 0 0 w 
w 0 w 0 0 0 0 0 0 0 g 0 0 w 
w 0 0 w w 0 0 0 0 w w 0 0 w 
w 0 0 0 0 0 0 0 0 0 0 0 0 w 
w 0 0 0 0 0 0 0 0 0 0 0 0 w 
w 0 0 0 0 0 0 0 0 w w w w w 
w 0 0 0 0 0 g 0 0 0 0 0 0 w 
w 0 c 0 0 w w w 0 0 0 0 0 w 
w w w w 0 0 0 0 0 0 0 0 0 w 
