level4
0
0
14
24
w w w w w w w w w w w w w w 
w g 0 0 0 0 0 0 0 0 0 0 0 w 
w 0 0 0 0 0 0 0 0 0 0 0 0 w 
w 0 0 0 w w w w 0 0 0 g g w 
w 0 f 0 w t 0 0 0 0 0 g g w 
w w w w w e 0 0 0 w w w w w 
w 0 g g w 0 0 0 0 0 0 0 0 w 
w t g g w t 0 0 0 0 0 0 0 w 
w 0 0 0 w w w w w w 0 0 0 w 
w 0 0 0 0 0 0 0 0 0 w 0 0 w 
w 0 0 0 0 0 0 0 0 0 0 w 0 w 
w e 0 0 0 w w w w 0 0 0 0 w 
w 0 0 0 w 0 0 0 0 w 0 0 0 w 
w 0 0 w 0 0 0 0 0 0 w w w w 
w 0 0 0 0 0 0 0 0 0 0 t 0 w 
w t 0 0 0 0 0 0 0 0 0 0 0 w 
w w w w w w 0 0 0 0 0 0 0 w 
w 0 0 0 0 0 0 0 0 0 0 e 0 w 
w 0 0 0 0 0 0 0 g 0 0 0 0 w 
w 0 0 0 0 0 w w w 0 0 0 0 w 
w 0 0 0 0 0 0 0 0 0 0 0 0 w 
w 0 c 0 0 0 0 0 0 0 0 t 0 w 
w w w w 0 0 0 0 0 0 0 0 0 w 
w 0 0 0 0 0 0 0 0 0 0 0 0 w

