level2
0
0
14
24
w w w w w w w w w w w w w w 
w 0 0 w w w 0 0 0 0 0 0 0 w 
w w 0 0 w 0 0 0 0 0 0 0 f w 
w w 0 0 0 0 0 0 0 g 0 0 w w 
w 0 0 g g 0 0 0 0 0 0 0 t w 
w 0 0 w w 0 w 0 0 0 0 0 0 w 
w 0 w w w 0 w w 0 0 0 0 e w 
w 0 0 0 0 0 0 w w w g 0 0 w 
w 0 0 0 0 0 0 0 0 w w 0 b w 
w w 0 0 g 0 0 0 0 w w w w w 
w 0 0 0 w 0 0 0 0 0 0 w w w 
w 0 0 0 0 0 0 0 0 g 0 0 w w 
w 0 w 0 0 0 0 0 0 w 0 0 w w 
w 0 0 0 0 0 w 0 0 0 w 0 0 w 
w 0 0 0 0 0 w 0 0 0 w 0 0 w 
w 0 g g 0 w 0 0 0 0 0 w 0 w 
w w w w w 0 0 0 0 w 0 0 0 w 
w t 0 0 0 0 0 0 0 0 0 0 g w 
w 0 0 0 0 0 0 w 0 0 0 0 w w 
w 0 0 0 0 0 0 0 0 0 0 0 0 w 
w e 0 0 0 g 0 0 0 0 0 0 0 w 
w b 0 0 w w w 0 0 0 0 0 0 w 
w c 0 0 0 0 0 0 0 0 0 0 0 w 
w w w w w w w w w w w w w w 
